#####################
#S  #   #           #
### ### # ######### #
# #   # # # #   #   #
# ### # # # # # # # #
#     # #   # #   # #
# ##### # ### #######
# # #     #   #     #
# # # ##### ### ### #
# #       #     #   #
# # ############# # #
# # # #           # #
# # # # ########### #
# #   # # #         #
# ##### # # #########
#       # #       # #
######### ####### # #
#   #         #   # #
# # # ### ##### ### #
# #     #          G#
#####################