###################################################
#S#     #   #       #       #       #             #
# # ### # ### ### ### ### # ##### # ############# #
# # # # #     # # #   # # #       #   #           #
# # # # ##### # # # ### # ########### # ###########
#   #   #   # # #   #   # #   #       #           #
##### ### # # # ##### # # # # # ######### ####### #
#   #     # #       # # #   # #     #   # #       #
# ######### ####### ### ##### ##### # # ### ##### #
# #       # #     #     #   # #   #   #   #     # #
# # ##### # # ####### ### # # # ######### ##### # #
# #   # # # #         #   # # #         #       # #
# ### # # # ########### ### # ### ##### ######### #
#   #   # #           #   #   #   #       #     # #
# # ### # ########### # # ##### ##### ##### # # # #
# # #   #         #   # #   #       #   #   # # # #
# ### ######### ### ####### # ##### ##### ### # # #
# #   # #     #   #     #   #   # # #     #   # # #
# # ### # ### ### ##### # ##### # # # ##### ##### #
# #     # #     #     #   #   #   # # #     #     #
# ##### # ##### # ######### # ### # # # # ### #####
# #     #   #   #           #   # #   # # #   #   #
# # ####### # ######### ##### ### ##### # # ### # #
# # #     # #           #   # #   # #   # #   # # #
# # # ### # ##### ####### # ### ### # ### ### # # #
#     #   # # #   #   #   #     #   #   # #   # # #
# ####### # # # ### # # ########### ### # # ### # #
# # #   # # #     # #   #           #   # #   # # #
# # # # ### ##### # ##### ####### # # ####### # ###
#   # #     #   # #   #   #       # #   #   # #   #
##### ##### # # ##### ##### ####### ### # # # ### #
#   # #   # # # #   #   #   #     # # #   # #     #
# # # # ### # # # # ### # ####### # # ##### ##### #
# #   # #   # #   #   #   #       #       #     # #
# ##### # ### ##### # ##### # ########### ##### # #
#     #     # # #   # #     # #   #   #     #   # #
# ### # ##### # # ### # ### # # # # # # ##### # # #
#   # #   #   # # #   #   # # # # # #     #   # # #
##### ### # ### # ####### # ### # # ####### ### # #
#   # #   #   # #     #   # #   # #   # #   #   # #
# # # ####### # ##### # ### # ### ### # # ### ### #
# #   #     # #     #   # # #   #   #   # #   #   #
# # ### ### # # ### ##### # ### # ##### # ##### ###
# # #   # #   # #   #   # #     # #     #       # #
# ### ### ##### # ### # # ####### # ############# #
# #   #     #   #     #     # #   #     #   #     #
# # ##### # # ############# # # ####### # # ### # #
# #   #   # # #     #     #   #   #     # #   # # #
# ### # ### # # ### # ### ### ### # ##### ### # # #
#       #     #   #     #       #         #     #G#
###################################################