############
#S         #
# ######## #
# #    #   #
# # #  # ###
#   #  #   #
### # ###  #
#   #   ## #
#   #   #  #
# ##### # ##
#   #   # G#
############