#####################################################################################################
#S#     # #           #     #               #           #         #       #         #         #   # #
# ### # # # # ####### # # ### ### ######### ### ####### # ### ##### # ### # ##### # # ####### # # # #
# #   #   # #   #   # # #     #   #     # #     # #     # #   #     # #   #   # # #   #     #   # # #
# # ####### ### # # ### ####### ### ### # ####### # ##### ##### ##### # ##### # # ##### ### ##### # #
# #   #       #   #       #     #   #     #       # #           #     #   #     #   # #   #     # # #
# # # # ################### ##### ######### # ##### ############# ####### ##### ### # # ####### # # #
# # #   #   #           #   # #     #       #     #       #       #         #     # #   #     #   # #
# # ####### # ######### # ### # ### # ########### ####### # ############### # ##### # ### ### # ### #
# #   #     #   #     #   #   #   # #           #       # # #           #   #   #   #   # #   #     #
# ### # ####### # ######### ##### # ########### ### # ### # # ######### # ##### # ####### # ####### #
#   #   #       # #         #     # #     #   # #   # #   #         # # # #     #         #   #   # #
### # ### ####### # ### # ### ##### # # # # ### # ### # ########### # # # ##### ########### # # # # #
#   # #   #   #   # # # # #   #   #   # #   #   # # # #         # #   # #     #   #       # # # #   #
# ##### ### # # # # # # # # ##### ##### ##### ### # # ######### # ### # ##### ##### ##### ### ##### #
#   #   #   #   # # # # # #     #     # #     #   # #     #   # #   # # #   #   #   #   #   #     # #
### # ### ####### # # # # ##### # ### # # ##### ### # ##### # # # ### # # # ### # ### # ### # ### # #
#   # #       #   # # # # #   # # # # # #   #   # #   #   # #   #     # # #   #   # # # #   # # # # #
# ### # ##### ### # # # ### # # # # # # ### # ### # ### # # ########### # ######### # # # ### # # ###
#   # # #   #   # # # #   # # #   #   #     # #     # # #   #           # #         # #   # #   #   #
### # # # # ### ### # ### # # ##### ######### ### ### # ######### ####### # ### ### # ##### ### ### #
# #   # # # # #   #     #   # #     #   #   #   #   # #           #   #     #   # # # #   #   # #   #
# ##### # # # ### ##### ##### # ##### # # # ### ### # ############# # # ##### ### # # # # ### # # ###
#     # # # #   #     #   # #   #     # # #   #   # #   #   #   #   # # #     #   # #   #   # # #   #
# # ### # # # ##### ##### # ##### ##### # # # ### # # # # ### # # ### # # ##### ### ####### # # ### #
# #   #   # #     # #   # #   #   #   #   # #   # #   #   #   #   # #   # #     #   #   #   #     # #
# ### ##### ### # # # # # # # # ##### ##### # ### ### ##### ####### ##### # ##### ### # # ######### #
# # #     #     # #   # #   # # #     #   # # #   #   #     #       #   # #       #   #   #         #
# # ### ######### ##### ##### # # ##### # # ### ### ### ##### ### ### # # # ####### ####### # ##### #
#     #     #     # #   #   # # #     # #   #   #     # #     #   #   # # # #       #     # #     # #
######### # # ##### # ### # # # # ### # ### # ### ##### ####### ### ### # ### ######### # # ##### # #
#         # #     # #     #   # # #   #   # # # # #   #     #   #   #   #   #           # # # #   # #
# ##### ######### # ########### # # ##### # # # # # # ##### # ### ### ##### ############# # # # ### #
# #     #   #     #     #     # # #     # # # #   # #       #   #   #     #       #   #   # # # #   #
# ####### # # ##### ### # # ### # ### ### # # # ### ######### # ### ##### ### ### ### # ### # # ### #
#     #   #   # #   # # # #     #   # #   # # #   #         # #   #   # #     # # #   #   #   #   # #
##### # ####### # ### # # ########### # ##### ############# # ### ### # ####### # # ##### ####### # #
#     #   #           # # #           # #     #         #   # #     # #     #     # #   #   #   # # #
# ####### ########### # # ##### ##### # # ##### ####### # ##### ##### # # ### ##### # # ### # # # # #
#   #   #           # # #       #     # #   #   #     #   #     #     # # #   #     # #   # # # # # #
# # # # ########### ### ##### ##### ### ### # ### ### ##### ### # ####### # ##### # # # ### # # # # #
# #   #   #       #   #     # #   #   # #   #   # # #   #   # # #       #         # # #   #   # # # #
# ####### # ##### ### ##### # # # # ### # ##### # # ### # ### # ####### ############# ### ##### # # #
#     # #   #   #     #   #   # # # #   #     # # #   #   #   #   #   # #   #   #   # #   #   # # # #
##### # ##### # ####### # # ### # ### # ##### # # ### ##### ##### ### # # # # # # # # # # # # # # ###
#     #       # #     # # # #   # #   #   #   #   #     #       #     #   #   # # #   # #   # # #   #
# ##### ### ### # ### # # ### ### # ##### # # ##### ##### ### ####### ######### # ##### ### ### # # #
# #   # # # # # #   # # # #   # #   #   # # #   #   #   # #   #           #     #   # #   # #   # # #
# # # # # # # # ### # # # # ### ##### # # # ### # ### # # # ### ########### ####### # ### # # ##### #
# # # # # # # #   # #   #   #       # #   # #     #   #   #   #       #     #     # #   # # #       #
# # # # # # # ### # ########### ### # ##### ####### ######### ##### ### ##### # ### # # # ######### #
# # #     # #   #   #   #     # #   #   # # #       #       #     # #   #   # #   #   # #   #     # #
# # ####### # ######### # # # # # # ### # # # ######### ### ### ### # ### # # ### ##### ### # ### # #
# #   #     # #       # # # # # # #   #   #   #         # #   #     #     # #   #   # # # # # #   # #
# # ### ##### # ### # # # # # ### # ##### ######### ##### ### ############# ### # # # # # # # # # # #
# # #   #   #   #   # #   # #     # #     #       # #   #     #           #   # # #   # # #   # # # #
# ### ### ### ### ### # ### ####### # ####### ### # # ### ##### ######### ### # # ##### # ##### ### #
#     #       #   # # # #   #     # #         # #   #     #   #         # # # # # #     #     # #   #
####### ####### ### # ### ### ### # ########### ##### ##### # # ####### # # # # # # ##### ### # # ###
#       #       #   #     #   #   #       #     #   #   #   #       #   #   # # #   #     # # #   # #
# ####### ####### ############# # # ####### # ### # ### ############# ##### # # ####### ### # ##### #
# #   # # #           # #       # # #       # #   # #   #             #   # #   #       #     #     #
# # # # # ##### ### # # # # # ##### # ####### # ### # ### ############# # # ####### ##### ##### # # #
#   #   # #   #   # #   # # # #   # # #       #   #   #     #         # # #         #     # #   # # #
######### # # ##### ##### # ### # # # # ##### ### ##### ### ####### # # # ########### ##### # ### # #
#       #   # #   # #   # #     # # # # #       #   # #   #     #   #   # #         # #   #   #   # #
# ##### ### # # # # # # # ####### # # # ##### ##### # ### ##### # # ##### # ### ### # ### # ### ### #
#   # #   # #   # #   #   #     #   # # #   # #     #       #   # # #   # # #   # # #   #     # #   #
# # # ### # ##### # ########### ##### # # # ### ##### ####### ### # # # # # # ### # ### ####### # ###
# # #     #   #   # #               # #   #   #     # #       #   # # # # # # #   #   #   #     #   #
# # ##### ##### ### ### # ##### ##### ####### ##### # # ######### ### # ### # # # # ##### # ####### #
# #     #   #   # #   # # #   # #     # #   #   #   # #   #       #   #     # # #   #     # #     # #
# ##### ### # ### ### # # # # ### ##### # # ### # ##### # # ####### ######### # ##### ##### # ##### #
# #     # #   #   #   # # # #     #       #   #   #   # # # #   #       #     # # #   #     #     # #
# # ##### ####### # ##### # ####### ####### # ##### # ### # # # # ####### ##### # # ### # ### ### # #
# #     #         #     # #     #   #       # #     #     # # #   # #   # #   #   #   # #   #   # # #
# ##### # ##### ####### # ##### ##### ####### ### ######### # ##### # # # # ##### ### # ### ### # # #
# # #   # #   #     #   # #     #     #   #       # #     #   #     # #   #       #   #   # #   #   #
# # # # ### # ### # # ### # ##### ##### # ######### # ### # ##### # # ########### # ####### #########
# # # # #   #   # #   #   #   #         #     #       #   # #     # #     #     # # #     #   #     #
# # # # # ##### # ##### # ### ##### ######### ######### ### ### ### ##### # ### ### # ### # # # ### #
#   # # # #     # #     # # #     # #       #         #   #     # #     # # # # #   # #   # #   #   #
# ### # # # ##### ##### # # ##### ### ##### ######### # # ####### # ##### # # # # ### # ### ##### # #
# #   # # # #           #       #   #   # #           # #           #     #   # #     # # #     # # #
# # ##### # ######### ######### ### ### # ################# ####### # ####### # ####### # ### ### # #
# #       #   #   #   #   #       #     # #         #     # #     # #     #   #     #   #     #   # #
# ########### # # ##### # # ############# # ####### # # # ### ### ##### # # ### ##### ### ##### ### #
#   #     # #   #   #   # #     #         #   #   # # # #     #   #   # # # #   #     #   #     #   #
### ### # # ####### # ### # ##### ### ####### # ### # # ####### ### # # # # # # # ######### ##### ###
# #   # # #   #     # # # # #     #   #     #   #   # # #     #   # # # #   # # #   #   #   #   #   #
# ### # # # # # ### # # # ### ##### ### ### ### # # # # # ### ### # # ####### ##### # # # ### ##### #
# #   # #   # # #   # # #     # #   #     # #   # # # # # #   #     # #       #   #   #   # #     # #
# # ### ##### # ##### # ####### # ### ##### # ### ### # # ### # ##### # ##### # # ######### # ### # #
#   #       # #       #       # # #   #     # # # #   # #   # # #   #   #   # # #   #   #   # # #   #
# ######### ############# ### # # # ### ### # # # # ### # # ### # # ### # # ### ### # # # # # # #####
#         #       #     #   # # # #   # #   #   # # #   # #   # # #   # # #     #   # #   #   #     #
######### ### ### # # # ### # # # ### # ####### # # # ##### # # # ### ### ####### # # ########### # #
#   #   #     #   # # #   # # # #     #       # #   # #   # #   #   #     #     # # # #         # # #
# ### # ####### ##### ### # # # ############# # ##### # # ######### ########### # ### ####### # ### #
#     #               #     #               #       #   #                       #             #    G#
#####################################################################################################