##########
#S       #
#  ### # #
#    # #G#
##########